#################################################.
#           #                #                  #
#                            #                  #
#                                               #
#           #                                   #
#############                #                  #
#                            #                  #
#                            #                  #
######################       ####################
#                    #       #                  #
#                    #       #                  #
#                            #                  #
#                            #                  #
#                    #       #                  #
#                    #       #                  #
######################       ####  ##############
#                                               #
#                                               #
#                                               #
#                                               #
###########  ###########                        #
#                      #                        #
#                      #                        #
#                      #                        #
#                      #                        #
#                      #                        #
#                      #                        #
#                      #                        #
#################################################


