#################################################.
#           #                #                  #
#                            #                  #
#                                               #
#           #                                   #
#############                #                  #
#                            #                  #
#                            ###############################
######################       #                  #          #
#                    #       #                  #          #
#                    #       #  %%  %%  %%  %%  #          #
#   %% %% %% %% %%   #       #                  #          #
#                            #  %%  %%  %%  %%             #
#                            #                             #
#   %% %% %% %% %%   #       #  %%  %%  %%  %%  #          #
#                    #       #                  #          #
#                    #       #                  #          #
######################       ####  #########################
#                                               #
#                                               #
#                                               #
#                                               #
###########  ############                       #
#                       #                       #
#                       #                       #
#   %% %% %% %% %% %%   #                       #
#                       #                       #
#   %% %% %% %% %% %%   #                       #
#                       #                       #
#   %% %% %% %% %% %%   #                       #
#                       #                       #
#                       #                       #
#################################################


